111111111111111
1P0000000E0E001
1C0000000E00001
111111111111111