111111111111111
100010C01000011
10000001C00E001
100000001000011
1P0000C0C000001
10000000C000001
100000000000001
10000000C000001
10100000C000011
111111111111111